"filename", "language", "C++", "C", "Markdown", "HTML", "comment", "blank", "total"
"/Users/steveyu/algorithm/2018年冬季PAT真题/7-1.Google Recruitment.cpp", "C++", 22, 0, 0, 0, 0, 1, 23
"/Users/steveyu/algorithm/2018年冬季PAT真题/7-2.Decode Registration Card of PAT.cpp", "C++", 65, 0, 0, 0, 2, 1, 68
"/Users/steveyu/algorithm/2018年冬季PAT真题/7-3.vetex color.cpp", "C++", 28, 0, 0, 0, 2, 1, 31
"/Users/steveyu/algorithm/2018年冬季PAT真题/7-4.Heap Path.cpp", "C++", 35, 0, 0, 0, 0, 1, 36
"/Users/steveyu/algorithm/2019年冬季PAT真题/1.HelloWorld.cpp", "C++", 36, 0, 0, 0, 2, 0, 38
"/Users/steveyu/algorithm/2019年冬季PAT真题/2.BlockReversing.cpp", "C++", 36, 0, 0, 0, 2, 1, 39
"/Users/steveyu/algorithm/2019年冬季PAT真题/3.summit.cpp", "C++", 43, 0, 0, 0, 2, 1, 46
"/Users/steveyu/algorithm/2019年冬季PAT真题/4.Cartesian Tree.cpp", "C++", 42, 0, 0, 0, 2, 1, 45
"/Users/steveyu/algorithm/2019年秋季PAT真题/7-1.forever num.cpp", "C++", 59, 0, 0, 0, 2, 14, 75
"/Users/steveyu/algorithm/2019年秋季PAT真题/7-2.merging linked list.cpp", "C++", 48, 0, 0, 0, 0, 0, 48
"/Users/steveyu/algorithm/2019年秋季PAT真题/7-3.postfix express.cpp", "C++", 29, 0, 0, 0, 0, 0, 29
"/Users/steveyu/algorithm/2019年秋季PAT真题/7-4.dijstra sequence.cpp", "C++", 56, 0, 0, 0, 3, 14, 73
"/Users/steveyu/algorithm/2020年春季PAT真题/1.cpp", "C++", 36, 0, 0, 0, 0, 0, 36
"/Users/steveyu/algorithm/2020年春季PAT真题/7-1.Prime Day.cpp", "C++", 20, 0, 0, 0, 0, 0, 20
"/Users/steveyu/algorithm/2020年春季PAT真题/7-2.The Judger.cpp", "C++", 38, 0, 0, 0, 1, 0, 39
"/Users/steveyu/algorithm/2020年春季PAT真题/7-3.Safari Park.cpp", "C++", 31, 0, 0, 0, 0, 0, 31
"/Users/steveyu/algorithm/2020年春季PAT真题/7-4.Replacement Selection.cpp", "C++", 35, 0, 0, 0, 0, 0, 35
"/Users/steveyu/algorithm/2020年春季PAT真题/a.cpp", "C++", 13, 0, 0, 0, 0, 0, 13
"/Users/steveyu/algorithm/3.23试卷/7-1.Knuth洗牌法.cpp", "C++", 17, 0, 0, 0, 0, 0, 17
"/Users/steveyu/algorithm/3.23试卷/7-2.三阶幸福数.cpp", "C++", 34, 0, 0, 0, 0, 0, 34
"/Users/steveyu/algorithm/3.23试卷/7-3.垃圾分类.cpp", "C++", 27, 0, 0, 0, 0, 0, 27
"/Users/steveyu/algorithm/PTA520/test.cpp", "C++", 35, 0, 0, 0, 0, 0, 35
"/Users/steveyu/algorithm/PTA520/test2.cpp", "C++", 4, 0, 0, 0, 0, 1, 5
"/Users/steveyu/algorithm/README.md", "Markdown", 0, 0, 2, 0, 0, 2, 4
"/Users/steveyu/algorithm/acwing/1.prefix sum.cpp", "C++", 17, 0, 0, 0, 0, 1, 18
"/Users/steveyu/algorithm/acwing/1.sum.cpp", "C++", 27, 0, 0, 0, 0, 2, 29
"/Users/steveyu/algorithm/acwing/2.diff.cpp", "C++", 38, 0, 0, 0, 0, 4, 42
"/Users/steveyu/algorithm/acwing/2.matrix sum.cpp", "C++", 19, 0, 0, 0, 0, 4, 23
"/Users/steveyu/algorithm/acwing/3.product.cpp", "C++", 25, 0, 0, 0, 0, 1, 26
"/Users/steveyu/algorithm/acwing/4.div.cpp", "C++", 29, 0, 0, 0, 0, 1, 30
"/Users/steveyu/algorithm/acwing/acwing253.avl tree.cpp", "C++", 23, 0, 0, 0, 0, 6, 29
"/Users/steveyu/algorithm/acwing/acwing785.quick sort.cpp", "C++", 22, 0, 0, 0, 1, 0, 23
"/Users/steveyu/algorithm/acwing/acwing786.the kth num.cpp", "C++", 21, 0, 0, 0, 3, 2, 26
"/Users/steveyu/algorithm/acwing/acwing787.merge sort.cpp", "C++", 27, 0, 0, 0, 0, 3, 30
"/Users/steveyu/algorithm/acwing/acwing788.reversed order.cpp", "C++", 28, 0, 0, 0, 0, 1, 29
"/Users/steveyu/algorithm/acwing/acwing789.num range.cpp", "C++", 32, 0, 0, 0, 0, 7, 39
"/Users/steveyu/algorithm/acwing/acwing790.num 3 pow.cpp", "C++", 14, 0, 0, 0, 0, 1, 15
"/Users/steveyu/algorithm/acwing/acwing835.trie tree.cpp", "C++", 34, 0, 0, 0, 0, 2, 36
"/Users/steveyu/algorithm/acwing/acwing842.sort num.cpp", "C++", 23, 0, 0, 0, 0, 0, 23
"/Users/steveyu/algorithm/acwing/acwing843.n queen puzzle.cpp", "C++", 29, 0, 0, 0, 0, 0, 29
"/Users/steveyu/algorithm/acwing/acwing844.maze.cpp", "C++", 29, 0, 0, 0, 2, 0, 31
"/Users/steveyu/algorithm/acwing/acwing845.eight number game.cpp", "C++", 6, 0, 0, 0, 0, 0, 6
"/Users/steveyu/algorithm/advanced/1001.A+B format.cpp", "C++", 20, 0, 0, 0, 0, 1, 21
"/Users/steveyu/algorithm/advanced/1002.A+B for Polynomials.cpp", "C++", 22, 0, 0, 0, 0, 1, 23
"/Users/steveyu/algorithm/advanced/1003.Emergency(练习堆优化).cpp", "C++", 47, 0, 0, 0, 0, 1, 48
"/Users/steveyu/algorithm/advanced/1003.Emergency.cpp", "C++", 48, 0, 0, 0, 0, 1, 49
"/Users/steveyu/algorithm/advanced/1004.counting leaves.cpp", "C++", 48, 0, 0, 0, 0, 0, 48
"/Users/steveyu/algorithm/advanced/1005.spell it right.cpp", "C++", 16, 0, 0, 0, 0, 1, 17
"/Users/steveyu/algorithm/advanced/1006.Sign in and Sign out.cpp", "C++", 21, 0, 0, 0, 0, 1, 22
"/Users/steveyu/algorithm/advanced/1007.Maximum Subsequence Sum.cpp", "C++", 24, 0, 0, 0, 1, 1, 26
"/Users/steveyu/algorithm/advanced/1008.elevator.cpp", "C++", 15, 0, 0, 0, 0, 1, 16
"/Users/steveyu/algorithm/advanced/1009.Product of Polynomials.cpp", "C++", 27, 0, 0, 0, 0, 1, 28
"/Users/steveyu/algorithm/advanced/1010.Radix.cpp", "C++", 26, 0, 0, 0, 0, 1, 27
"/Users/steveyu/algorithm/advanced/1011.World Cup Betting.cpp", "C++", 24, 0, 0, 0, 0, 1, 25
"/Users/steveyu/algorithm/advanced/1012.The Best Rank.cpp", "C++", 45, 0, 0, 0, 0, 1, 46
"/Users/steveyu/algorithm/advanced/1013.Battle Over Cities.cpp", "C++", 37, 0, 0, 0, 0, 1, 38
"/Users/steveyu/algorithm/advanced/1014.Waiting in line.cpp", "C++", 60, 0, 0, 0, 0, 1, 61
"/Users/steveyu/algorithm/advanced/1015.Reversible Primes.cpp", "C++", 38, 0, 0, 0, 0, 1, 39
"/Users/steveyu/algorithm/advanced/1016.Phone Bills.cpp", "C++", 56, 0, 0, 0, 0, 0, 56
"/Users/steveyu/algorithm/advanced/1017.Queueing at Bank.cpp", "C++", 36, 0, 0, 0, 0, 0, 36
"/Users/steveyu/algorithm/advanced/1018.Public Bike Management.cpp", "C++", 36, 0, 0, 0, 0, 0, 36
"/Users/steveyu/algorithm/advanced/1019.General Palindromic Number.cpp", "C++", 21, 0, 0, 0, 0, 1, 22
"/Users/steveyu/algorithm/advanced/1020.Tree Traversals.cpp", "C++", 35, 0, 0, 0, 0, 1, 36
"/Users/steveyu/algorithm/advanced/1021.Deepest Root.cpp", "C++", 47, 0, 0, 0, 2, 0, 49
"/Users/steveyu/algorithm/advanced/1022.Digital Library.cpp", "C++", 42, 0, 0, 0, 0, 1, 43
"/Users/steveyu/algorithm/advanced/1023.Have Fun with Numbers.cpp", "C++", 30, 0, 0, 0, 0, 0, 30
"/Users/steveyu/algorithm/advanced/1024.Palidromic Number.cpp", "C++", 29, 0, 0, 0, 0, 0, 29
"/Users/steveyu/algorithm/advanced/1025.PAT Ranking.cpp", "C++", 47, 0, 0, 0, 0, 1, 48
"/Users/steveyu/algorithm/advanced/1026.Table Tennis.cpp", "C++", 119, 0, 0, 0, 0, 0, 119
"/Users/steveyu/algorithm/advanced/1027.Colors in Mars.cpp", "C++", 9, 0, 0, 0, 0, 1, 10
"/Users/steveyu/algorithm/advanced/1028.List Sorting.cpp", "C++", 22, 0, 0, 0, 0, 1, 23
"/Users/steveyu/algorithm/advanced/1029.Median.cpp", "C++", 30, 0, 0, 0, 0, 1, 31
"/Users/steveyu/algorithm/advanced/1030.Travel Plan.cpp", "C++", 30, 0, 0, 0, 0, 1, 31
"/Users/steveyu/algorithm/advanced/1031.Hello World for U.cpp", "C++", 17, 0, 0, 0, 0, 1, 18
"/Users/steveyu/algorithm/advanced/1032.Sharing.cpp", "C++", 35, 0, 0, 0, 3, 1, 39
"/Users/steveyu/algorithm/advanced/1033.To Fill or Not to Fill.cpp", "C++", 61, 0, 0, 0, 0, 0, 61
"/Users/steveyu/algorithm/advanced/1034.Head of Gang.cpp", "C++", 61, 0, 0, 0, 0, 0, 61
"/Users/steveyu/algorithm/advanced/1035.Password.cpp", "C++", 29, 0, 0, 0, 0, 1, 30
"/Users/steveyu/algorithm/advanced/1036.Boys and Girls.cpp", "C++", 28, 0, 0, 0, 0, 1, 29
"/Users/steveyu/algorithm/advanced/1037.Magic Coupon.cpp", "C++", 17, 0, 0, 0, 0, 1, 18
"/Users/steveyu/algorithm/advanced/1038.Recover the Smallest Number.cpp", "C++", 23, 0, 0, 0, 0, 1, 24
"/Users/steveyu/algorithm/advanced/1039.Course List for Student.cpp", "C++", 25, 0, 0, 0, 0, 1, 26
"/Users/steveyu/algorithm/advanced/1040.Longest Symmetric String.cpp", "C++", 19, 0, 0, 0, 0, 1, 20
"/Users/steveyu/algorithm/advanced/1041.Be Unique.cpp", "C++", 20, 0, 0, 0, 0, 1, 21
"/Users/steveyu/algorithm/advanced/1042.Shuffling Machine.cpp", "C++", 27, 0, 0, 0, 0, 1, 28
"/Users/steveyu/algorithm/advanced/1043.Is it a Binary Search Tree.cpp", "C++", 41, 0, 0, 0, 0, 0, 41
"/Users/steveyu/algorithm/advanced/1044.Shopping in Mars.cpp", "C++", 42, 0, 0, 0, 0, 0, 42
"/Users/steveyu/algorithm/advanced/1045.Favorite Color Stripe.cpp", "C++", 27, 0, 0, 0, 0, 0, 27
"/Users/steveyu/algorithm/advanced/1046.Shortest Distance.cpp", "C++", 23, 0, 0, 0, 0, 1, 24
"/Users/steveyu/algorithm/advanced/1047.Student List for Course.cpp", "C++", 26, 0, 0, 0, 0, 1, 27
"/Users/steveyu/algorithm/advanced/1048.FindCoins.cpp", "C++", 21, 0, 0, 0, 0, 1, 22
"/Users/steveyu/algorithm/advanced/1049.Counting Ones.cpp", "C++", 15, 0, 0, 0, 0, 0, 15
"/Users/steveyu/algorithm/advanced/1050.String Subtraction.cpp", "C++", 13, 0, 0, 0, 0, 1, 14
"/Users/steveyu/algorithm/advanced/1051.Pop Sequence.cpp", "C++", 26, 0, 0, 0, 0, 0, 26
"/Users/steveyu/algorithm/advanced/1052.Linked List Sorting.cpp", "C++", 36, 0, 0, 0, 0, 0, 36
"/Users/steveyu/algorithm/advanced/1053.Path of Equal Weight.cpp", "C++", 46, 0, 0, 0, 0, 1, 47
"/Users/steveyu/algorithm/advanced/1054.The Dominant Color.cpp", "C++", 24, 0, 0, 0, 0, 1, 25
"/Users/steveyu/algorithm/advanced/1055.The World's Richest.cpp", "C++", 34, 0, 0, 0, 0, 1, 35
"/Users/steveyu/algorithm/advanced/1056.Mice and Rice.cpp", "C++", 62, 0, 0, 0, 0, 0, 62
"/Users/steveyu/algorithm/advanced/1057.Stack.cpp", "C++", 55, 0, 0, 0, 0, 0, 55
"/Users/steveyu/algorithm/advanced/1058.A+B in Hogwarts.cpp", "C++", 11, 0, 0, 0, 0, 1, 12
"/Users/steveyu/algorithm/advanced/1059.Prime Factors.cpp", "C++", 11, 0, 0, 0, 0, 1, 12
"/Users/steveyu/algorithm/advanced/1060.Are They Equal.cpp", "C++", 43, 0, 0, 0, 0, 1, 44
"/Users/steveyu/algorithm/advanced/1061.Dating.cpp", "C++", 24, 0, 0, 0, 0, 0, 24
"/Users/steveyu/algorithm/advanced/1062.Talent and Virtue.cpp", "C++", 35, 0, 0, 0, 0, 1, 36
"/Users/steveyu/algorithm/advanced/1063.Set Similarity.cpp", "C++", 27, 0, 0, 0, 0, 1, 28
"/Users/steveyu/algorithm/advanced/1064.Complete Binary Search Tree.cpp", "C++", 25, 0, 0, 0, 0, 1, 26
"/Users/steveyu/algorithm/advanced/1065.A+B and C.cpp", "C++", 21, 0, 0, 0, 0, 0, 21
"/Users/steveyu/algorithm/advanced/1066.Root of AVL Tree.cpp", "C++", 58, 0, 0, 0, 6, 0, 64
"/Users/steveyu/algorithm/advanced/1067.Sort with Swap(0,i).cpp", "C++", 27, 0, 0, 0, 0, 0, 27
"/Users/steveyu/algorithm/advanced/1068.Find More Coins.cpp", "C++", 39, 0, 0, 0, 0, 0, 39
"/Users/steveyu/algorithm/advanced/1069.The Black Hole of Numbers.cpp", "C++", 18, 0, 0, 0, 0, 1, 19
"/Users/steveyu/algorithm/advanced/1070.Mooncake.cpp", "C++", 33, 0, 0, 0, 0, 1, 34
"/Users/steveyu/algorithm/advanced/1071.Speech Patterns.cpp", "C++", 25, 0, 0, 0, 0, 1, 26
"/Users/steveyu/algorithm/advanced/1072.Gas Station.cpp", "C++", 80, 0, 0, 0, 0, 1, 81
"/Users/steveyu/algorithm/advanced/1073.Scientific Notation.cpp", "C++", 35, 0, 0, 0, 0, 1, 36
"/Users/steveyu/algorithm/advanced/1074.Reversing Linked List.cpp", "C++", 36, 0, 0, 0, 0, 0, 36
"/Users/steveyu/algorithm/advanced/1075.PAT Judge.cpp", "C++", 66, 0, 0, 0, 0, 2, 68
"/Users/steveyu/algorithm/advanced/1076.Forward on Weibo.cpp", "C++", 51, 0, 0, 0, 0, 1, 52
"/Users/steveyu/algorithm/advanced/1077.Kuchiguse.cpp", "C++", 26, 0, 0, 0, 0, 1, 27
"/Users/steveyu/algorithm/advanced/1078.Hashing.cpp", "C++", 30, 0, 0, 0, 0, 1, 31
"/Users/steveyu/algorithm/advanced/1079.Total Sales of Supply Chain.cpp", "C++", 31, 0, 0, 0, 0, 0, 31
"/Users/steveyu/algorithm/advanced/1080.Graduate Admission.cpp", "C++", 51, 0, 0, 0, 0, 0, 51
"/Users/steveyu/algorithm/advanced/1081.Rational Sum.cpp", "C++", 45, 0, 0, 0, 0, 1, 46
"/Users/steveyu/algorithm/advanced/1082.Read Number in Chinese.cpp", "C++", 47, 0, 0, 0, 0, 1, 48
"/Users/steveyu/algorithm/advanced/1083.List Grades.cpp", "C++", 33, 0, 0, 0, 0, 2, 35
"/Users/steveyu/algorithm/advanced/1084.Broken Keyboards.cpp", "C++", 20, 0, 0, 0, 0, 1, 21
"/Users/steveyu/algorithm/advanced/1085.Perfect Sequence.cpp", "C++", 27, 0, 0, 0, 0, 1, 28
"/Users/steveyu/algorithm/advanced/1086.Tree Traversals Again.cpp", "C++", 36, 0, 0, 0, 0, 1, 37
"/Users/steveyu/algorithm/advanced/1087.All Roads Lead to Rome.cpp", "C++", 91, 0, 0, 0, 0, 0, 91
"/Users/steveyu/algorithm/advanced/1088.Rational Arithmetic.cpp", "C++", 46, 0, 0, 0, 6, 1, 53
"/Users/steveyu/algorithm/advanced/1089.Insert or Merge.cpp", "C++", 38, 0, 0, 0, 0, 0, 38
"/Users/steveyu/algorithm/advanced/1090.Highest Price in Supply Chain.cpp", "C++", 29, 0, 0, 0, 0, 1, 30
"/Users/steveyu/algorithm/advanced/1091.Acute Stroke.cpp", "C++", 62, 0, 0, 0, 0, 1, 63
"/Users/steveyu/algorithm/advanced/1092.To Buy or Not to Buy.cpp", "C++", 18, 0, 0, 0, 0, 1, 19
"/Users/steveyu/algorithm/advanced/1093.Count PAT's.cpp", "C++", 17, 0, 0, 0, 0, 1, 18
"/Users/steveyu/algorithm/advanced/1094.The Largest Generation.cpp", "C++", 35, 0, 0, 0, 0, 1, 36
"/Users/steveyu/algorithm/advanced/1095.Cars on Campus.cpp", "C++", 74, 0, 0, 0, 0, 0, 74
"/Users/steveyu/algorithm/advanced/1096.Consecutive Factors.cpp", "C++", 29, 0, 0, 0, 0, 1, 30
"/Users/steveyu/algorithm/advanced/1097.Deduplication on a Linked List.cpp", "C++", 38, 0, 0, 0, 0, 1, 39
"/Users/steveyu/algorithm/advanced/1098.Insertion or Heap Sort.cpp", "C++", 37, 0, 0, 0, 0, 0, 37
"/Users/steveyu/algorithm/advanced/1099.Build A Binary Search Tree.cpp", "C++", 35, 0, 0, 0, 0, 0, 35
"/Users/steveyu/algorithm/advanced/1100.Mars Numbers.cpp", "C++", 38, 0, 0, 0, 0, 1, 39
"/Users/steveyu/algorithm/advanced/1101.Quick Sort.cpp", "C++", 26, 0, 0, 0, 0, 1, 27
"/Users/steveyu/algorithm/advanced/1102.Invert a Binary Tree.cpp", "C++", 59, 0, 0, 0, 0, 1, 60
"/Users/steveyu/algorithm/advanced/1103.Integer Factorization.cpp", "C++", 45, 0, 0, 0, 0, 1, 46
"/Users/steveyu/algorithm/advanced/1104.Sum of Number Segments.cpp", "C++", 14, 0, 0, 0, 0, 1, 15
"/Users/steveyu/algorithm/advanced/1105.Spiral Matrix.cpp", "C++", 43, 0, 0, 0, 0, 0, 43
"/Users/steveyu/algorithm/advanced/1106.Lowest Price in Supply Chain.cpp", "C++", 35, 0, 0, 0, 0, 0, 35
"/Users/steveyu/algorithm/advanced/1107.Social Clusters.cpp", "C++", 52, 0, 0, 0, 0, 0, 52
"/Users/steveyu/algorithm/advanced/1108.find average.cpp", "C++", 32, 0, 0, 0, 1, 0, 33
"/Users/steveyu/algorithm/advanced/1109.Group Photo.cpp", "C++", 40, 0, 0, 0, 0, 0, 40
"/Users/steveyu/algorithm/advanced/1110.Complete Binary Tree.cpp", "C++", 48, 0, 0, 0, 0, 0, 48
"/Users/steveyu/algorithm/advanced/1111.Online Map.cpp", "C++", 111, 0, 0, 0, 4, 1, 116
"/Users/steveyu/algorithm/advanced/1112.Stucked Keyboard.cpp", "C++", 45, 0, 0, 0, 0, 0, 45
"/Users/steveyu/algorithm/advanced/1113.Integer Set Partition.cpp", "C++", 18, 0, 0, 0, 0, 0, 18
"/Users/steveyu/algorithm/advanced/1114.Family Property.cpp", "C++", 81, 0, 0, 0, 0, 0, 81
"/Users/steveyu/algorithm/advanced/1115.Counting Nodes in a BST.cpp", "C++", 28, 0, 0, 0, 0, 0, 28
"/Users/steveyu/algorithm/advanced/1116.Come on! Let's C.cpp", "C++", 36, 0, 0, 0, 0, 1, 37
"/Users/steveyu/algorithm/advanced/1117.Eddington Number.cpp", "C++", 15, 0, 0, 0, 0, 0, 15
"/Users/steveyu/algorithm/advanced/1118.Birds in Forest.cpp", "C++", 46, 0, 0, 0, 0, 0, 46
"/Users/steveyu/algorithm/advanced/1119.pre- and post-order traversals.cpp", "C++", 40, 0, 0, 0, 0, 0, 40
"/Users/steveyu/algorithm/advanced/1120.Friend Numbers.cpp", "C++", 21, 0, 0, 0, 0, 0, 21
"/Users/steveyu/algorithm/advanced/1121.Damn Single.cpp", "C++", 41, 0, 0, 0, 0, 0, 41
"/Users/steveyu/algorithm/advanced/1122.Hamiltonian Cycle.cpp", "C++", 33, 0, 0, 0, 0, 0, 33
"/Users/steveyu/algorithm/advanced/1123.Is It a Complete AVL Tree.cpp", "C++", 82, 0, 0, 0, 0, 0, 82
"/Users/steveyu/algorithm/advanced/1124.Raffle for Weibo Followers.cpp", "C++", 19, 0, 0, 0, 0, 0, 19
"/Users/steveyu/algorithm/advanced/1125.Chain the Ropes.cpp", "C++", 15, 0, 0, 0, 0, 0, 15
"/Users/steveyu/algorithm/advanced/1126.Eulerian Path.cpp", "C++", 36, 0, 0, 0, 1, 0, 37
"/Users/steveyu/algorithm/advanced/1127.ZigZagging.cpp", "C++", 54, 0, 0, 0, 0, 0, 54
"/Users/steveyu/algorithm/advanced/1128.N Queens Puzzle.cpp", "C++", 23, 0, 0, 0, 0, 0, 23
"/Users/steveyu/algorithm/advanced/1129.Recommendation System.cpp", "C++", 31, 0, 0, 0, 0, 0, 31
"/Users/steveyu/algorithm/advanced/1130.Infix Expression.cpp", "C++", 32, 0, 0, 0, 0, 0, 32
"/Users/steveyu/algorithm/advanced/1131.Subway Map.cpp", "C++", 69, 0, 0, 0, 0, 0, 69
"/Users/steveyu/algorithm/advanced/1132.Cut Integer.cpp", "C++", 14, 0, 0, 0, 0, 0, 14
"/Users/steveyu/algorithm/advanced/1133.Splitting A Linked List.cpp", "C++", 35, 0, 0, 0, 0, 0, 35
"/Users/steveyu/algorithm/advanced/1134.Vertex Cover.cpp", "C++", 28, 0, 0, 0, 0, 0, 28
"/Users/steveyu/algorithm/advanced/1135.Is It A Red-Black Tree.cpp", "C++", 46, 0, 0, 0, 0, 0, 46
"/Users/steveyu/algorithm/advanced/1136.A Delayed Palindrome.cpp", "C++", 57, 0, 0, 0, 0, 0, 57
"/Users/steveyu/algorithm/advanced/1137.Final Grading.cpp", "C++", 51, 0, 0, 0, 0, 0, 51
"/Users/steveyu/algorithm/advanced/1138.Postorder Traversal.cpp", "C++", 21, 0, 0, 0, 0, 0, 21
"/Users/steveyu/algorithm/advanced/1139.First Contact.cpp", "C++", 40, 0, 0, 0, 0, 0, 40
"/Users/steveyu/algorithm/advanced/1140.Look-and-say Sequence.cpp", "C++", 24, 0, 0, 0, 0, 0, 24
"/Users/steveyu/algorithm/advanced/1141.PAT Ranking of Institutions.cpp", "C++", 56, 0, 0, 0, 0, 0, 56
"/Users/steveyu/algorithm/advanced/1142.Maximal Clique.cpp", "C++", 42, 0, 0, 0, 1, 0, 43
"/Users/steveyu/algorithm/advanced/1143.Lowest Common Ancestor.cpp", "C++", 48, 0, 0, 0, 0, 0, 48
"/Users/steveyu/algorithm/advanced/1144.The Missing Number.cpp", "C++", 19, 0, 0, 0, 0, 0, 19
"/Users/steveyu/algorithm/advanced/1145.Hash - Average Search Time.cpp", "C++", 39, 0, 0, 0, 0, 2, 41
"/Users/steveyu/algorithm/advanced/1146.Topological Order.cpp", "C++", 31, 0, 0, 0, 0, 0, 31
"/Users/steveyu/algorithm/advanced/1147.Heaps.cpp", "C++", 39, 0, 0, 0, 0, 0, 39
"/Users/steveyu/algorithm/advanced/1148.Werewolf - Simple Version.cpp", "C++", 25, 0, 0, 0, 0, 1, 26
"/Users/steveyu/algorithm/advanced/1149.Dangerous Goods Packaging.cpp", "C++", 37, 0, 0, 0, 0, 0, 37
"/Users/steveyu/algorithm/advanced/1150.Travelling Salesman Problem.cpp", "C++", 41, 0, 0, 0, 0, 0, 41
"/Users/steveyu/algorithm/advanced/1151.LCA in a Binary Tree.cpp", "C++", 54, 0, 0, 0, 0, 1, 55
"/Users/steveyu/algorithm/advanced/1152.Google Recruitment.cpp", "C++", 24, 0, 0, 0, 0, 0, 24
"/Users/steveyu/algorithm/advanced/1153.Decode Registration Card of PAT.cpp", "C++", 50, 0, 0, 0, 4, 0, 54
"/Users/steveyu/algorithm/advanced/1154.Vertex Coloring.cpp", "C++", 30, 0, 0, 0, 0, 0, 30
"/Users/steveyu/algorithm/advanced/1155.Heap Path.cpp", "C++", 36, 0, 0, 0, 1, 1, 38
"/Users/steveyu/algorithm/data-structure-pta/7-1.max_substance.cpp", "C++", 15, 0, 0, 0, 0, 1, 16
"/Users/steveyu/algorithm/data-structure-pta/7-10.connect every city(Kruskal).cpp", "C++", 27, 0, 0, 0, 0, 1, 28
"/Users/steveyu/algorithm/data-structure-pta/7-10.connect every city(Prim).cpp", "C++", 38, 0, 0, 0, 0, 1, 39
"/Users/steveyu/algorithm/data-structure-pta/7-11.key activity.cpp", "C++", 45, 0, 0, 0, 2, 1, 48
"/Users/steveyu/algorithm/data-structure-pta/7-2.polynomia_plus_and_multi.cpp", "C++", 43, 0, 0, 0, 0, 1, 44
"/Users/steveyu/algorithm/data-structure-pta/7-20.express transfer.cpp", "C++", 42, 0, 0, 0, 3, 1, 46
"/Users/steveyu/algorithm/data-structure-pta/7-26.windows message queue.cpp", "C++", 28, 0, 0, 0, 2, 1, 31
"/Users/steveyu/algorithm/data-structure-pta/7-3.the_isomorphism_of_tree.cpp", "C++", 55, 0, 0, 0, 0, 1, 56
"/Users/steveyu/algorithm/data-structure-pta/7-4.is_it_a_binary_search_tree.cpp", "C++", 48, 0, 0, 0, 0, 1, 49
"/Users/steveyu/algorithm/data-structure-pta/7-49.print choose course.cpp", "C++", 25, 0, 0, 0, 0, 1, 26
"/Users/steveyu/algorithm/data-structure-pta/7-5.the_path_in_heap.cpp", "C++", 28, 0, 0, 0, 0, 1, 29
"/Users/steveyu/algorithm/data-structure-pta/7-50.minmium spend(kruskal).cpp", "C++", 44, 0, 0, 0, 3, 1, 48
"/Users/steveyu/algorithm/data-structure-pta/7-50.minmium spend.cpp", "C++", 29, 0, 0, 0, 2, 1, 32
"/Users/steveyu/algorithm/data-structure-pta/7-51.merge two list.cpp", "C++", 27, 0, 0, 0, 0, 1, 28
"/Users/steveyu/algorithm/data-structure-pta/7-52.intersection.cpp", "C++", 25, 0, 0, 0, 0, 1, 26
"/Users/steveyu/algorithm/data-structure-pta/7-53.middle num.cpp", "C++", 34, 0, 0, 0, 0, 0, 34
"/Users/steveyu/algorithm/data-structure-pta/7-6.list_conn_set.cpp", "C++", 51, 0, 0, 0, 2, 1, 54
"/Users/steveyu/algorithm/data-structure-pta/7-7.six_space.cpp", "C++", 41, 0, 0, 0, 0, 0, 41
"/Users/steveyu/algorithm/data-structure-pta/7-8.harry_potter_test.cpp", "C++", 65, 0, 0, 0, 2, 11, 78
"/Users/steveyu/algorithm/data-structure-pta/7-9.travel plan.cpp", "C++", 43, 0, 0, 0, 0, 1, 44
"/Users/steveyu/algorithm/dp/1.字符串猜想.cpp", "C++", 13, 0, 0, 0, 12, 3, 28
"/Users/steveyu/algorithm/dp/fibnacci.c", "C", 0, 16, 0, 0, 1, 0, 17
"/Users/steveyu/algorithm/dp/optmize_for_money.cpp", "C++", 12, 0, 0, 0, 0, 0, 12
"/Users/steveyu/algorithm/dp/subset.cpp", "C++", 13, 0, 0, 0, 0, 1, 14
"/Users/steveyu/algorithm/graph/shorest_path/all_roads_lead_to_rome.cpp", "C++", 91, 0, 0, 0, 0, 0, 91
"/Users/steveyu/algorithm/graph/shorest_path/emergency.cpp", "C++", 0, 0, 0, 0, 0, 1, 1
"/Users/steveyu/algorithm/graph/shorest_path/gas_station.cpp", "C++", 0, 0, 0, 0, 0, 1, 1
"/Users/steveyu/algorithm/graph/shorest_path/public_bike_management.cpp", "C++", 0, 0, 0, 0, 0, 1, 1
"/Users/steveyu/algorithm/graph/shorest_path/subway_map.cpp", "C++", 68, 0, 0, 0, 0, 0, 68
"/Users/steveyu/algorithm/graph/shorest_path/travel_plan.cpp", "C++", 0, 0, 0, 0, 0, 1, 1
"/Users/steveyu/algorithm/graph/traversal/battle_over_cities.cpp", "C++", 37, 0, 0, 0, 0, 1, 38
"/Users/steveyu/algorithm/graph/traversal/deepest_root.cpp", "C++", 47, 0, 0, 0, 2, 0, 49
"/Users/steveyu/algorithm/graph/traversal/forwords_on_weibo.cpp", "C++", 7, 0, 0, 0, 0, 0, 7
"/Users/steveyu/algorithm/graph/traversal/head_of_a_gang.cpp", "C++", 0, 0, 0, 0, 0, 1, 1
"/Users/steveyu/algorithm/ideas/LifeIsInterest.cpp", "C++", 5, 0, 0, 0, 1, 0, 6
"/Users/steveyu/algorithm/ideas/N.cpp", "C++", 28, 0, 0, 0, 0, 0, 28
"/Users/steveyu/algorithm/ideas/array.cpp", "C++", 21, 0, 0, 0, 0, 0, 21
"/Users/steveyu/algorithm/leetcode/1.Two Sum.cpp", "C++", 16, 0, 0, 0, 3, 0, 19
"/Users/steveyu/algorithm/leetcode/10.Regular Expression Matching.cpp", "C++", 28, 0, 0, 0, 8, 2, 38
"/Users/steveyu/algorithm/leetcode/11.Container With Most Water.cpp", "C++", 17, 0, 0, 0, 2, 0, 19
"/Users/steveyu/algorithm/leetcode/12.Integer to Roman.cpp", "C++", 17, 0, 0, 0, 2, 0, 19
"/Users/steveyu/algorithm/leetcode/13.Roman to Integer.cpp", "C++", 21, 0, 0, 0, 2, 0, 23
"/Users/steveyu/algorithm/leetcode/14.Longest Common Prefix.cpp", "C++", 21, 0, 0, 0, 1, 0, 22
"/Users/steveyu/algorithm/leetcode/15.3Sum.cpp", "C++", 21, 0, 0, 0, 6, 0, 27
"/Users/steveyu/algorithm/leetcode/16.3Sum Closest.cpp", "C++", 22, 0, 0, 0, 2, 1, 25
"/Users/steveyu/algorithm/leetcode/17.Letter Combinations of a Phone Number.cpp", "C++", 20, 0, 0, 0, 2, 0, 22
"/Users/steveyu/algorithm/leetcode/2.Add Two Numbers.cpp", "C++", 21, 0, 0, 0, 5, 0, 26
"/Users/steveyu/algorithm/leetcode/3.Longest Substring Without Repeating Characters.cpp", "C++", 19, 0, 0, 0, 2, 0, 21
"/Users/steveyu/algorithm/leetcode/4.Median of Two Sorted Arrays.cpp", "C++", 27, 0, 0, 0, 9, 0, 36
"/Users/steveyu/algorithm/leetcode/5.Longest Palindromic Substring.cpp", "C++", 18, 0, 0, 0, 3, 0, 21
"/Users/steveyu/algorithm/leetcode/6.ZigZag Conversion.cpp", "C++", 22, 0, 0, 0, 9, 1, 32
"/Users/steveyu/algorithm/leetcode/7.Reverse Integer.cpp", "C++", 23, 0, 0, 0, 2, 0, 25
"/Users/steveyu/algorithm/leetcode/8.String To Integer.cpp", "C++", 23, 0, 0, 0, 4, 0, 27
"/Users/steveyu/algorithm/leetcode/9.Palindrome Number.cpp", "C++", 12, 0, 0, 0, 1, 0, 13
"/Users/steveyu/algorithm/practice/1150.cpp", "C++", 37, 0, 0, 0, 1, 0, 38
"/Users/steveyu/algorithm/practice/1151.cpp", "C++", 48, 0, 0, 0, 1, 0, 49
"/Users/steveyu/algorithm/practice/1152.cpp", "C++", 21, 0, 0, 0, 0, 0, 21
"/Users/steveyu/algorithm/practice/1153.cpp", "C++", 48, 0, 0, 0, 1, 0, 49
"/Users/steveyu/algorithm/practice/1154.cpp", "C++", 24, 0, 0, 0, 2, 0, 26
"/Users/steveyu/algorithm/practice/1155.cpp", "C++", 34, 0, 0, 0, 0, 0, 34
"/Users/steveyu/algorithm/sort/integerfac.cpp", "C++", 45, 0, 0, 0, 0, 0, 45
"/Users/steveyu/algorithm/sort/next.c", "C", 0, 8, 0, 0, 0, 0, 8
"/Users/steveyu/algorithm/sort/radix_counting_sort.cpp", "C++", 47, 0, 0, 0, 0, 0, 47
"/Users/steveyu/algorithm/sort/son.cpp", "C++", 14, 0, 0, 0, 2, 0, 16
"/Users/steveyu/algorithm/sort/tempCodeRunnerFile.cpp", "C++", 1, 0, 0, 0, 0, 0, 1
"/Users/steveyu/algorithm/sort/tri-tree.cpp", "C++", 0, 0, 0, 0, 0, 1, 1
"/Users/steveyu/algorithm/test/1144.missing.cpp", "C++", 13, 0, 0, 0, 0, 0, 13
"/Users/steveyu/algorithm/test/a.cpp", "C++", 44, 0, 0, 0, 0, 0, 44
"/Users/steveyu/algorithm/test/a.html", "HTML", 0, 0, 0, 30, 0, 5, 35
"/Users/steveyu/algorithm/test/clique.cpp", "C++", 41, 0, 0, 0, 1, 0, 42
"/Users/steveyu/algorithm/test/dangerous goods packaging.cpp", "C++", 21, 0, 0, 0, 1, 0, 22
"/Users/steveyu/algorithm/test/findPivot.cpp", "C++", 20, 0, 0, 0, 1, 0, 21
"/Users/steveyu/algorithm/test/firstcontact.cpp", "C++", 31, 0, 0, 0, 0, 0, 31
"/Users/steveyu/algorithm/test/hash-avg.cpp", "C++", 37, 0, 0, 0, 1, 0, 38
"/Users/steveyu/algorithm/test/heaps.cpp", "C++", 34, 0, 0, 0, 1, 0, 35
"/Users/steveyu/algorithm/test/lca.cpp", "C++", 48, 0, 0, 0, 1, 0, 49
"/Users/steveyu/algorithm/test/patranking.cpp", "C++", 37, 0, 0, 0, 1, 0, 38
"/Users/steveyu/algorithm/test/post.cpp", "C++", 21, 0, 0, 0, 0, 0, 21
"/Users/steveyu/algorithm/test/test.cpp", "C++", 29, 0, 0, 0, 0, 0, 29
"/Users/steveyu/algorithm/test/topological.cpp", "C++", 28, 0, 0, 0, 1, 0, 29
"/Users/steveyu/algorithm/test/werewolf.cpp", "C++", 24, 0, 0, 0, 0, 0, 24
"/Users/steveyu/algorithm/top/1021.Safe Fruit.cpp", "C++", 38, 0, 0, 0, 0, 1, 39
"/Users/steveyu/algorithm/tree/avl_tree/is_it_a_complete_avl_tree.cpp", "C++", 101, 0, 0, 0, 0, 1, 102
"/Users/steveyu/algorithm/tree/avl_tree/root_of_avl_tree.cpp", "C++", 58, 0, 0, 0, 6, 0, 64
"/Users/steveyu/algorithm/tree/binary_search_tree/build_a_binary_search_tree.cpp", "C++", 35, 0, 0, 0, 0, 0, 35
"/Users/steveyu/algorithm/tree/binary_search_tree/complete_binary_search_tree.cpp", "C++", 25, 0, 0, 0, 0, 1, 26
"/Users/steveyu/algorithm/tree/binary_search_tree/is_it_a_binary_search_tree.cpp", "C++", 41, 0, 0, 0, 0, 0, 41
"/Users/steveyu/algorithm/tree/binary_tree/complete_binary_tree.cpp", "C++", 55, 0, 0, 0, 0, 1, 56
"/Users/steveyu/algorithm/tree/binary_tree/invert_a_binary_tree.cpp", "C++", 48, 0, 0, 0, 0, 0, 48
"/Users/steveyu/algorithm/tree/binary_tree/lca_in_binary_tree.cpp", "C++", 53, 0, 0, 0, 0, 0, 53
"/Users/steveyu/algorithm/tree/binary_tree/lowest_common_ancestor.cpp", "C++", 52, 0, 0, 0, 0, 0, 52
"/Users/steveyu/algorithm/tree/binary_tree/pre_and_post_order_traversals.cpp", "C++", 40, 0, 0, 0, 0, 0, 40
"/Users/steveyu/algorithm/tree/binary_tree/tempCodeRunnerFile.cpp", "C++", 1, 0, 0, 0, 2, 0, 3
"/Users/steveyu/algorithm/tree/binary_tree/tree_traversal_again.cpp", "C++", 37, 0, 0, 0, 0, 0, 37
"/Users/steveyu/algorithm/tree/binary_tree/tree_traversals.cpp", "C++", 25, 0, 0, 0, 0, 0, 25
"/Users/steveyu/algorithm/tree/binary_tree/zigzagging_on_a_tree.cpp", "C++", 43, 0, 0, 0, 0, 0, 43
"/Users/steveyu/algorithm/tree/common_tree/counting_leaves.cpp", "C++", 32, 0, 0, 0, 0, 0, 32
"/Users/steveyu/algorithm/tree/common_tree/high_price_in_supply_chain.cpp", "C++", 29, 0, 0, 0, 0, 1, 30
"/Users/steveyu/algorithm/tree/common_tree/lowest_price_in_supply_chain.cpp", "C++", 32, 0, 0, 0, 0, 1, 33
"/Users/steveyu/algorithm/tree/common_tree/path_of_equal_weight.cpp", "C++", 46, 0, 0, 0, 0, 1, 47
"/Users/steveyu/algorithm/tree/common_tree/postorder_traversal.cpp", "C++", 22, 0, 0, 0, 0, 1, 23
"/Users/steveyu/algorithm/tree/common_tree/the_largest_generation.cpp", "C++", 35, 0, 0, 0, 0, 1, 36
"/Users/steveyu/algorithm/tree/common_tree/total_sales_of_supply_chain.cpp", "C++", 31, 0, 0, 0, 0, 0, 31
"/Users/steveyu/algorithm/tree/heap/heap_paths.cpp", "C++", 36, 0, 0, 0, 0, 0, 36
"/Users/steveyu/algorithm/tree/heap/heaps.cpp", "C++", 39, 0, 0, 0, 0, 0, 39
"/Users/steveyu/algorithm/tree/heap/insertion_or_heap_sort.cpp", "C++", 14, 0, 0, 0, 0, 1, 15
"/Users/steveyu/algorithm/tree/red_black_tree/is_it_a_red_black_tree.cpp", "C++", 46, 0, 0, 0, 0, 0, 46
"/Users/steveyu/algorithm/浙大2017考研复试上机模拟/1.N Queen Puzzle.cpp", "C++", 22, 0, 0, 0, 2, 1, 25
"/Users/steveyu/algorithm/浙大2017考研复试上机模拟/2.Recommend System.cpp", "C++", 39, 0, 0, 0, 2, 1, 42
"/Users/steveyu/algorithm/浙大2017考研复试上机模拟/3.Infix Expression.cpp", "C++", 32, 0, 0, 0, 2, 1, 35
"/Users/steveyu/algorithm/浙大2017考研复试上机模拟/4.subway map.cpp", "C++", 81, 0, 0, 0, 0, 2, 83
"/Users/steveyu/algorithm/浙大2018考研复试上机模拟/7-1.The Missing Number.cpp", "C++", 16, 0, 0, 0, 0, 1, 17
"/Users/steveyu/algorithm/浙大2018考研复试上机模拟/7-2.Hash - Average Search Time.cpp", "C++", 39, 0, 0, 0, 2, 1, 42
"/Users/steveyu/algorithm/浙大2018考研复试上机模拟/7-3.Topological Order.cpp", "C++", 34, 0, 0, 0, 0, 1, 35
"/Users/steveyu/algorithm/浙大2018考研复试上机模拟/7-4.Heaps.cpp", "C++", 39, 0, 0, 0, 0, 0, 39
"/Users/steveyu/algorithm/浙大2019保研上机模拟卷/1.Happy Numbers.cpp", "C++", 25, 0, 0, 0, 2, 1, 28
"/Users/steveyu/algorithm/浙大2019保研上机模拟卷/2.Zigzag Sequence.cpp", "C++", 36, 0, 0, 0, 2, 1, 39
"/Users/steveyu/algorithm/浙大2019保研上机模拟卷/3.Is it a AVL Tree.cpp", "C++", 37, 0, 0, 0, 0, 1, 38
"/Users/steveyu/algorithm/浙大2019保研上机模拟卷/4.Index of Popularity.cpp", "C++", 39, 0, 0, 0, 2, 1, 42
"/Users/steveyu/algorithm/浙大2019年考研复试上机模拟/1.Conway's Conjecture.cpp", "C++", 29, 0, 0, 0, 2, 2, 33
"/Users/steveyu/algorithm/浙大2019年考研复试上机模拟/2.Play with LinkedList.cpp", "C++", 37, 0, 0, 0, 2, 1, 40
"/Users/steveyu/algorithm/浙大2019年考研复试上机模拟/3.Unsuccessful Searchers.cpp", "C++", 26, 0, 0, 0, 2, 0, 28
"/Users/steveyu/algorithm/浙大2019年考研复试上机模拟/4.ambulance dispatch.cpp", "C++", 115, 0, 0, 0, 0, 2, 117
"/Users/steveyu/algorithm/甲级/1003.Emergency(练习堆优化).cpp", "C++", 47, 0, 0, 0, 0, 1, 48
"/Users/steveyu/algorithm/甲级/1003.Emergency.cpp", "C++", 48, 0, 0, 0, 0, 1, 49
"/Users/steveyu/algorithm/甲级/1092.To Buy or Not to Buy.cpp", "C++", 18, 0, 0, 0, 0, 1, 19
"/Users/steveyu/algorithm/甲级/1093.Count PAT's.cpp", "C++", 17, 0, 0, 0, 0, 1, 18
"/Users/steveyu/algorithm/甲级/1094.The Largest Generation.cpp", "C++", 35, 0, 0, 0, 0, 1, 36
"/Users/steveyu/algorithm/甲级/1095.Cars on Campus.cpp", "C++", 74, 0, 0, 0, 0, 0, 74
"/Users/steveyu/algorithm/甲级/1096.Consecutive Factors.cpp", "C++", 29, 0, 0, 0, 0, 1, 30
"/Users/steveyu/algorithm/甲级/1097.Deduplication on a Linked List.cpp", "C++", 38, 0, 0, 0, 0, 1, 39
"/Users/steveyu/algorithm/甲级/1098.Insertion or Heap Sort.cpp", "C++", 37, 0, 0, 0, 0, 0, 37
"/Users/steveyu/algorithm/甲级/1099.Build A Binary Search Tree.cpp", "C++", 35, 0, 0, 0, 0, 0, 35
"/Users/steveyu/algorithm/甲级/1100.Mars Numbers.cpp", "C++", 38, 0, 0, 0, 0, 1, 39
"/Users/steveyu/algorithm/甲级/1101.Quick Sort.cpp", "C++", 26, 0, 0, 0, 0, 1, 27
"/Users/steveyu/algorithm/甲级/1102.Invert a Binary Tree.cpp", "C++", 59, 0, 0, 0, 0, 1, 60
"/Users/steveyu/algorithm/甲级/1103.Integer Factorization.cpp", "C++", 45, 0, 0, 0, 0, 1, 46
"/Users/steveyu/algorithm/甲级/1104.Sum of Number Segments.cpp", "C++", 14, 0, 0, 0, 0, 1, 15
"/Users/steveyu/algorithm/甲级/1105.Spiral Matrix.cpp", "C++", 43, 0, 0, 0, 0, 0, 43
"/Users/steveyu/algorithm/甲级/1106.Lowest Price in Supply Chain.cpp", "C++", 35, 0, 0, 0, 0, 0, 35
"/Users/steveyu/algorithm/甲级/1107.Social Clusters.cpp", "C++", 52, 0, 0, 0, 0, 0, 52
"/Users/steveyu/algorithm/甲级/1108.find average.cpp", "C++", 32, 0, 0, 0, 1, 0, 33
"/Users/steveyu/algorithm/甲级/1109.Group Photo.cpp", "C++", 40, 0, 0, 0, 0, 0, 40
"/Users/steveyu/algorithm/甲级/1110.Complete Binary Tree.cpp", "C++", 48, 0, 0, 0, 0, 0, 48
"/Users/steveyu/algorithm/甲级/1111.Online Map.cpp", "C++", 111, 0, 0, 0, 4, 1, 116
"/Users/steveyu/algorithm/甲级/1112.Stucked Keyboard.cpp", "C++", 45, 0, 0, 0, 0, 0, 45
"/Users/steveyu/algorithm/甲级/1113.Integer Set Partition.cpp", "C++", 18, 0, 0, 0, 0, 0, 18
"/Users/steveyu/algorithm/甲级/1114.Family Property.cpp", "C++", 81, 0, 0, 0, 0, 0, 81
"/Users/steveyu/algorithm/甲级/1115.Counting Nodes in a BST.cpp", "C++", 28, 0, 0, 0, 0, 0, 28
"/Users/steveyu/algorithm/甲级/1116.Come on! Let's C.cpp", "C++", 36, 0, 0, 0, 0, 1, 37
"/Users/steveyu/algorithm/甲级/1117.Eddington Number.cpp", "C++", 15, 0, 0, 0, 0, 0, 15
"/Users/steveyu/algorithm/甲级/1118.Birds in Forest.cpp", "C++", 46, 0, 0, 0, 0, 0, 46
"/Users/steveyu/algorithm/甲级/1119.pre- and post-order traversals.cpp", "C++", 40, 0, 0, 0, 0, 0, 40
"/Users/steveyu/algorithm/甲级/1120.Friend Numbers.cpp", "C++", 21, 0, 0, 0, 0, 0, 21
"/Users/steveyu/algorithm/甲级/1121.Damn Single.cpp", "C++", 41, 0, 0, 0, 0, 0, 41
"/Users/steveyu/algorithm/甲级/1122.Hamiltonian Cycle.cpp", "C++", 33, 0, 0, 0, 0, 0, 33
"/Users/steveyu/algorithm/甲级/1123.Is It a Complete AVL Tree.cpp", "C++", 82, 0, 0, 0, 0, 0, 82
"/Users/steveyu/algorithm/甲级/1124.Raffle for Weibo Followers.cpp", "C++", 19, 0, 0, 0, 0, 0, 19
"/Users/steveyu/algorithm/甲级/1125.Chain the Ropes.cpp", "C++", 15, 0, 0, 0, 0, 0, 15
"/Users/steveyu/algorithm/甲级/1126.Eulerian Path.cpp", "C++", 36, 0, 0, 0, 1, 0, 37
"/Users/steveyu/algorithm/甲级/1127.ZigZagging.cpp", "C++", 54, 0, 0, 0, 0, 0, 54
"/Users/steveyu/algorithm/甲级/1128.N Queens Puzzle.cpp", "C++", 23, 0, 0, 0, 0, 0, 23
"/Users/steveyu/algorithm/甲级/1129.Recommendation System.cpp", "C++", 31, 0, 0, 0, 0, 0, 31
"/Users/steveyu/algorithm/甲级/1130.Infix Expression.cpp", "C++", 32, 0, 0, 0, 0, 0, 32
"/Users/steveyu/algorithm/甲级/1131.Subway Map.cpp", "C++", 69, 0, 0, 0, 0, 0, 69
"/Users/steveyu/algorithm/甲级/1132.Cut Integer.cpp", "C++", 14, 0, 0, 0, 0, 0, 14
"/Users/steveyu/algorithm/甲级/1133.Splitting A Linked List.cpp", "C++", 35, 0, 0, 0, 0, 0, 35
"/Users/steveyu/algorithm/甲级/1134.Vertex Cover.cpp", "C++", 28, 0, 0, 0, 0, 0, 28
"/Users/steveyu/algorithm/甲级/1135.Is It A Red-Black Tree.cpp", "C++", 46, 0, 0, 0, 0, 0, 46
"/Users/steveyu/algorithm/甲级/1136.A Delayed Palindrome.cpp", "C++", 57, 0, 0, 0, 0, 0, 57
"/Users/steveyu/algorithm/甲级/1137.Final Grading.cpp", "C++", 51, 0, 0, 0, 0, 0, 51
"/Users/steveyu/algorithm/甲级/1138.Postorder Traversal.cpp", "C++", 21, 0, 0, 0, 0, 0, 21
"/Users/steveyu/algorithm/甲级/1139.First Contact.cpp", "C++", 40, 0, 0, 0, 0, 0, 40
"/Users/steveyu/algorithm/甲级/1140.Look-and-say Sequence.cpp", "C++", 24, 0, 0, 0, 0, 0, 24
"/Users/steveyu/algorithm/甲级/1141.PAT Ranking of Institutions.cpp", "C++", 56, 0, 0, 0, 0, 0, 56
"/Users/steveyu/algorithm/甲级/1142.Maximal Clique.cpp", "C++", 42, 0, 0, 0, 1, 0, 43
"/Users/steveyu/algorithm/甲级/1143.Lowest Common Ancestor.cpp", "C++", 48, 0, 0, 0, 0, 0, 48
"/Users/steveyu/algorithm/甲级/1144.The Missing Number.cpp", "C++", 19, 0, 0, 0, 0, 0, 19
"/Users/steveyu/algorithm/甲级/1145.Hash - Average Search Time.cpp", "C++", 39, 0, 0, 0, 0, 2, 41
"/Users/steveyu/algorithm/甲级/1146.Topological Order.cpp", "C++", 31, 0, 0, 0, 0, 0, 31
"/Users/steveyu/algorithm/甲级/1147.Heaps.cpp", "C++", 39, 0, 0, 0, 0, 0, 39
"/Users/steveyu/algorithm/甲级/1148.Werewolf - Simple Version.cpp", "C++", 25, 0, 0, 0, 0, 1, 26
"/Users/steveyu/algorithm/甲级/1149.Dangerous Goods Packaging.cpp", "C++", 37, 0, 0, 0, 0, 0, 37
"/Users/steveyu/algorithm/甲级/1150.Travelling Salesman Problem.cpp", "C++", 41, 0, 0, 0, 0, 0, 41
"/Users/steveyu/algorithm/甲级/1151.LCA in a Binary Tree.cpp", "C++", 54, 0, 0, 0, 0, 0, 54
"/Users/steveyu/algorithm/甲级/1152.Google Recruitment.cpp", "C++", 24, 0, 0, 0, 0, 0, 24
"/Users/steveyu/algorithm/甲级/1153.Decode Registration Card of PAT.cpp", "C++", 50, 0, 0, 0, 4, 0, 54
"/Users/steveyu/algorithm/甲级/1154.Vertex Coloring.cpp", "C++", 30, 0, 0, 0, 0, 0, 30
"/Users/steveyu/algorithm/甲级/1155.Heap Path.cpp", "C++", 36, 0, 0, 0, 1, 0, 37
"/Users/steveyu/algorithm/程序员面试金典/01.01.字符串唯一.cpp", "C++", 14, 0, 0, 0, 1, 1, 16
"/Users/steveyu/algorithm/程序员面试金典/01.02.判定是否重排.cpp", "C++", 17, 0, 0, 0, 1, 1, 19
"/Users/steveyu/algorithm/程序员面试金典/01.03.URL化.cpp", "C++", 12, 0, 0, 0, 0, 0, 12
"/Users/steveyu/algorithm/程序员面试金典/01.04.回文排列.cpp", "C++", 13, 0, 0, 0, 0, 0, 13
"/Users/steveyu/algorithm/程序员面试金典/01.05.一次编辑.cpp", "C++", 16, 0, 0, 0, 0, 0, 16
"/Users/steveyu/algorithm/程序员面试金典/01.06.字符串压缩.cpp", "C++", 19, 0, 0, 0, 1, 0, 20
"/Users/steveyu/algorithm/考前模考/Insertion or Merge.cpp", "C++", 44, 0, 0, 0, 0, 0, 44
"/Users/steveyu/algorithm/考前模考/highest price in supply chain.cpp", "C++", 37, 0, 0, 0, 2, 0, 39
"/Users/steveyu/algorithm/考前模考/insertion or heap.cpp", "C++", 37, 0, 0, 0, 0, 0, 37
"/Users/steveyu/algorithm/考前模考/rational arithmetic.cpp", "C++", 45, 0, 0, 0, 6, 1, 52
"/Users/steveyu/algorithm/考前模考/vis.cpp", "C++", 68, 0, 0, 0, 3, 0, 71
"/Users/steveyu/algorithm/钻石样卷1/7-1.是不是太胖了.cpp", "C++", 8, 0, 0, 0, 0, 0, 8
"/Users/steveyu/algorithm/钻石样卷1/7-2.装睡.cpp", "C++", 13, 0, 0, 0, 0, 0, 13
"/Users/steveyu/algorithm/钻石样卷1/7-3.到底是不是太胖了.cpp", "C++", 15, 0, 0, 0, 0, 1, 16
"/Users/steveyu/algorithm/钻石样卷1/7-4.到底有多二.cpp", "C++", 22, 0, 0, 0, 0, 0, 22
"/Users/steveyu/algorithm/钻石样卷1/7-5.c语言竞赛.cpp", "C++", 36, 0, 0, 0, 0, 0, 36
"/Users/steveyu/algorithm/钻石样卷1/7-6.查字典.cpp", "C++", 20, 0, 0, 0, 0, 0, 20
"/Users/steveyu/algorithm/钻石样卷1/tempCodeRunnerFile.cpp", "C++", 7, 0, 0, 0, 0, 0, 7
"/Users/steveyu/algorithm/高级数据结构/main.cpp", "C++", 16, 0, 0, 0, 0, 0, 16
"/Users/steveyu/algorithm/高级数据结构/redblacktree.c", "C", 0, 448, 0, 0, 17, 51, 516
"/Users/steveyu/algorithm/高级数据结构/redblacktree.cpp", "C++", 166, 0, 0, 0, 19, 37, 222
"/Users/steveyu/algorithm/高级数据结构/redblacktree.h", "C++", 25, 0, 0, 0, 0, 5, 30
"/Users/steveyu/algorithm/高级数据结构/splaytree.c", "C", 0, 0, 0, 0, 0, 1, 1
"Total", "-", 14020, 472, 2, 30, 254, 346, 15124